1 1
9 9 9 9 9 9 9 9 9 9
9 9 9 9 9 9 9 9 9 9
9 9 9 9 9 9 9 9 9 9
9 9 12 9 9 9 9 9 9 9
9 9 8 9 9 9 9 9 9 9
9 9 2 8 1 8 8 9 9 9
9 9 9 9 9 9 1 9 9 9
9 9 9 9 9 9 8 9 9 9
8 8 8 8 8 8 8 9 9 9
8 9 9 9 9 9 7 9 9 9
