0 1
9 9 7 9 9 9 9 9 9 9
9 9 8 9 9 9 9 9 9 9
9 9 8 9 9 9 9 9 9 9
9 9 8 9 9 9 9 9 9 9
9 9 1 9 9 9 11 9 9 9
9 9 8 8 1 8 8 9 9 9
9 9 8 9 9 9 9 9 9 9
9 9 8 9 9 9 9 9 9 9
8 8 8 9 9 9 9 9 9 9
8 9 9 9 9 9 9 9 9 9
